All maps are 65 long i hope

11111111111111111111111111111111111111111111111111111111111111
10000000000000000000000000000000000000000000000000000000000001
10001100000000000000000000000000000000000000000000000000000001
10000000000000000000000000000000000000000000000000000000000001
10000000000000000000000000000000000000000000000000000000000001
10000000000000000000000000000000000000011111111111000000000001
10000000000000000000000000000000000000011111111111000000000001
11100000000000000011000000110000000000011111111111000000000001
11111111111111111111000011111000000000000000000110000000000001
11111111111111111111000011111000000000000000000110000000000001
11111111111111111111000001100000000000000000000110000000000001
11111111111111111111000001000000000000000000001100000000000001
11111111111111111111000001000000000000000000111000000000000001
11111111111111111111000000000000000000000001100000000000000001
10001100000000000111111111000000000000000011111000000000000001
10001100000000000111111111000000000000000000000000000000000001
10001100000000000111111111000000000000000000000000000000000001
10001100000000000111111111000000000000000000000000000000000001
10000000000000000000000000000000000000000000000000000000000001
10000000000000000000000000000000000000000000000000000000000001
10000000000000000000000000000000000000000000000000000000000001
11111111111111111111111111111111111111111111111111111111111111


11111111111111111111111111111111111111111111111111111111111111
10000000000000000000000000000000000000000000000000000000000001
10000000000000000000000000000000111000000000000000000000000001
10000000000000000000000000000001111100000000000000000000000001
10000000000000001111111111111111111000000000000000000000000001
10000000000000011111111111111111111000000000000000000000000001
10000000000000001111111111111111111000000000000000000000000001
10000000000000000000000000000001111100000000000000000000000001
10000000000000000000000000000000111000000000000000000000000001
10000000000000000000000000000000000000000000000000000000000001
10000000000000000000000000000000000000000000000000000000000001
11111111111111111111111111111111111111111111111111111111111111

11111111111111111111111111111111111111111111111111111111111111
10000000000000000000000000000000000000000000000000000000000001
10000000000011111000000000000000000000000000000000000000000001
10000000000010000000000000000000000000000000000000000000000001
11111111111110000000000000010000000000000000000000000000000001
10000000000000000000000000010000000000000000000000000000000001
10000000000000000000000000010000000000000000000000000000000001
10000111111111111111111111110000000000000000000000000000000001
10000000000000000000000000000000000000000000000000000000000001
10000000011111111111110000000000000000000000000000000000000001
10000000010000000000000000000000000000000000000000000000000001
10000000001000000000000000000000000000000000000000000000000001
10000000001000000000000000000000000000000000000000000000000001
10000000001000000000000000000000000000000000000000000000000001
11111111111111111111111111111111111111111111111111111111111111

11111111111111111111111111111111111111111111111111111111111111
10000000000000000000004000000000000000400000000000000000000001
10000000000011111111111111111111111111111111111000000000000001
10000000000210000000000000000000400000004000001000000030000001
11111111111110000111111111110000000000000000001000000000000001
10000000000000000000000000010000000400000000001111111111100001
10000000000000000000000000010000000000000000000000000000000001
10000000040000000040000000011111111111111111111111110000200001
10000000000000000000000000010000000000000000000000011111111111
10000000040000000040000000010111111111111111111111010000000001
10000000000000000000000000010100000000000000000000010000000001
10000000040003000040000000010101111111111111111111110000000001
10000000000000000000000000010101000020000000000000010000000001
10000000002000002000000000000100000000000000000000000000000001
11111111111111111111111111111111111111111111111111111111111111

11111111111111111111111111111111111111111111111111111111111111
12200000000000000300000040000040000004000000000000000000000001
10000000000011111111111111111111111111111111111000000000000001
10000000000010000000000000000000000000000000001000000000000001
11111111111110000111111111110000400000040000001000000030000001
10000000000000000000000000010000000000000000001111111111100001
10000000000000000000000000010000000400000000000000000000000001
10000000400000000400000000011111111111111111111111110000200001
10000000000000000000000000010000000000000000000000011111111111
10000000400000000400000000010111111111111111111111010000000001
10000000000000000000000000010100000000000000000000010000000001
10000000000030000000000000010101111111111111111111110000000001
10000000000000000000000000010101000020000020000000010000000001
10000000000020000000000000000100000000000000000000000000000001
11111111111111111111111111111111111111111111111111111111111111

11111111111111111111111111111111111111111111111111111111111111
12222220000000000000000000000000000000000000000000000000000001
10000000000011111111111111111111111111111111111000000000000001
10000000000010000000000000000000000000000000001000000000000001
11111111111110000111111111110000000000000000001000000000000001
10000000000000000000000000010000000000000000001111111111100001
10000000000000000000000000010000000000000000000000000000000001
10000000000000000000000000011111111111111111111111110000000001
10000000000000000000000000010000000000000000000000011111111111
10000000000000000000000000010111111111111111111111010000000001
10000000000000000000000000010100000000000000000000010000000001
10000000000000000000000000010101111111111111111111110000000001
10000000000000000000000000010101000000000000000000010000000001
10000000000000000000000000000100000000000000000000000000000001
11111111111111111111111111111111111111111111111111111111111111