11111111111111111111111111111111111111111111111111111111111111
10000000000000000000000000000000000000000000000000000000000001
10000000000011111000000000000000000000000000000000000000000001
10000000000010000000000000000000000000000000000000000000000001
11111111111110000000000000010000000000000000000000000000000001
10000000000000000000000000010000000000000000000000000000000001
10000000000000000000000000010000000000000000000000000000000001
10000111111111111111111111110000000000000000000000000000000001
10000000000000000000000000000000000000000000000000000000000001
10000000011111111111110000000000000000000000000000000000000001
10000000010000000000000000000000000000000000000000000000000001
10000000001000000000000000000000000000000000000000000000000001
10000000001000000000000000000000000000000000000000000000000001
10000000001000000000000000000000000000000000000000000000000001
11111111111111111111111111111111111111111111111111111111111111