11111111111111111111111111111111111111111111111111111111111111
12200000300000000000000040000040000004000000000000000000000001
10000000000011111111111111111111111111111111111000000000000001
10000000000010000000000000000000000000000000001000000000000001
11111111111110000111111111110000400000040000001000000030000001
10000000000000000000000000010000000000000000001111111111100001
10000000000000000000000000010000000400000000000000000000000001
10000000400000000400000000011111111111111111111111110000200001
10000000000000000000000000010000000000000000000000011111111111
10000000400000000400000000010111111111111111111111010000000001
10000000000000000000000000010100000000000000000000010000000001
10000000000030000000000000010101111111111111111111110000000001
10000000000000000000000000010101000020000020000000010000000001
10000000000020000000000000000100000000000000000000000000000001
11111111111111111111111111111111111111111111111111111111111111