11111111111111111111111111111111111111111111111111111111111111
12222000000000400000000030000030000003000000000000000000000001
10000000000011111111111111111111111111111111111000000000000001
100000000*0010000000000000000000000000000000001000000000000001
11111111111110000111111111110000300000030000001000000040000001
10000000000000000000000000012000000000000000001111111111100001
10000000000000000000000000010000000300000000000000000000000001
10000000300000000300000000011111111111111111111111110000200001
10000000000000000000000000010000000000000000000000011111111111
10000000300000000300000000010111111111111111111111010000000001
10000000000000000000000000010100000000000000000000010030030001
10000000000040000000000000010101111111111111111111110030030001
10000000000000000000000000010101000020000020000000010030030001
10000000000022000000000000000100000000000000000000000000000001
11111111111111111111111111111111111111111111111111111111111111