11111111111111111111111111111111111111111111111111111111111111
10000000000000000000000000000000000000000000000000000000000001
10001100000000000000000000000000000000000000000000000000000001
10000000000000000000000300000000030000000000000000000000000001
10000000000000000000000000000000000000000000000000000000000001
10000000000000000000000000000000000000011111111111000000000001
10000000000000000000000000000000000000011111111111000000000001
11100000000000000011000000110000000000011111111111000000000001
11111111111111111111000011111000000000000004002110000000000001
11111111111111111111000011111000000000000000002110000000000001
11111111111111111111000001100000000000000004002110000000000001
11111111111111111111000001000000000000000000001100000000000001
11111111111111111111000001000000000000000000111000000000000001
11111111111111111111000000000000000000000001100000000000000001
10001100222200000111111111000000030000000011111000000000000001
10001100000000000111111111000000000000000000000000000000000001
10001100040404000111111111000000000000000000000000000000000001
10001100303030300111111111000000000000000000000000000000000001
10000000000000000000000000000000030000000000000000000000000001
10000000000000000000000000000000000000000000000000000000000001
11111111111111111111111111111111111111111111111111111111111111