11111111111111111111111111111111111111111111111111111111111111
10000000000000000000000000000000000000000000000000000000000001
10000000000011111111111111111111111111111111111000000000000001
10000000*00010000000000000000000000000000000001000000000000001
11111111111110000111111111110000000000000000001000000000000001
10000000000000000000000000010000000000000000001111111111100001
10000000000000000000000000010000000000000000000000000000000001
10000000000000000000000000011111111111111111111111110000000001
10000000000000000000000000010000000000000000000000011111111111
10000000000000000000000000010111111111111111111111010000000001
10000000000000000000000000010100000000000000000000010000000001
10000000000000000000000000010101111111111111111111110000000001
10000000000000000000000000010101000000000000000000010000000001
10000000000000000000000000000100000000000000000000000000000001
11111111111111111111111111111111111111111111111111111111111111
